111111111111
100000000001
101110111101
100000000001
111111111111

